R 1920 1000

NO ./resurs/textures/wall_one.xpm
SO ./resurs/textures/wall_two.xpm
WE ./resurs/textures/wall_three.xpm
EA ./resurs/textures/wall_four.xpm
S    ./resurs/textures/rick_3.xpm
F    55,41,12
C   53,76,78

111111
102021
100001
100N01
100001
110211
110011
100001
111111
